11111111111
1P000C000E1
100000C0101
1C1001CCCC1
1CCCC1CCCC1
100C010C001
11100011101
100C111CCC1
11111111111
